----------
----------
----------
----------
----@-----
----@-----
--@@@@@#--
--@-@-----
----@@@&--
----------