----------
----------
--&-------
-@@@@@@@--
-@-----@--
-@@@---@--
---@@@@@--
-----@-@--
-#@@@@@@--
----------