----------
----------
----------
-@@@@@----
-@---@@&--
-@@@------
---@@@@@--
-@@@---@--
-#@---@@--
----------