----------
----------
----------
-11111----
-1---111--
1111------
---11111--
-111---1--
-01---11--
----------