----------
----------
----------
----------
----1-----
----1-----
--111110--
--1-1-----
----1112--
----------