----------
----------
--2-------
-1111111--
-1-----1--
-111---1--
---11111--
-----1-1--
-0111111--
----------